11111111111111111111111111111111111111111111111111111111111111111111111
11111111111111111100000000000000000000011110000000000000000000000011111
10000000000000010000000000000000000000011110000000000000000000000000111
1000P000000000010000000000000000000000011110000000000000000000000000011
10000000000000010000000000000000000000001100000000C00000000100000000011
10000000C00000000000000000C00000000000001100000000000000000100000000011
10000000000000010000000000000000000000001100000000000000001000000C00111
10000000000000010000000000000000000000000000000000000000000100000000011
10000000000000010000000000000000000000000100000000000000000100000000011
10000000000000010000000000000000000000000100000000000000000100000000011
1000000011111111000000000C000000000000000100000000000000000111111111111
10000000000000010000000000000000000000000100000000000000000100000000011
10000000000000010000000000000000000000000100000000000000000100000000011
10000000000000010000000000000000000000000100000000000000000000000000001
10111111111111111110111111111111111111111000000000000000000100000000011
10000000000000010000000001111111111111111000000000000000000100000000011
10000000000000010000000000111111111111111000000000000000000010000C00001
10000000000000010000000000011111111111111000000000000000000100000000011
10000000000000010000000000001111111111111000000000000000000010000C00001
10111111111110010000000000000111111111111000000000000000000100000000011
101C0000000000010000000000000011111111111000000000000010000010000C00001
10111111111111110000000000000000000000001011111111111111111100000000011
100000000000000000000000000000000000000010000000000E0000000010000C00001
11111111111111111111111111111111111111111111111111111111111111111111111